4B33B3F3B4
B07B37702B
258S228252
5469220665
00XX00XX00
00XX00XX00
52B0567B84
28B4B9BB35
23674SF272
3625232436